 --- --- --- --- --- --- --- --- --- 
| ^                                 |
                                     
|                                   |
                                     
|                                   |
                                     
|                                   |
                                     
|                                 x |
 --- --- --- --- --- --- --- --- --- 