 --- --- --- --- --- --- --- --- --- 
|       |       |       |       | x |
                                     
|   |   |   |   |   |   |   |   |   |
                                     
|   |   |   |   |   |   |   |   |   |
                                     
|   |   |   |   |   |   |   |   |   |
                                     
| v |       |       |       |       |
 --- --- --- --- --- --- --- --- --- 