 --- --- --- --- --- --- --- --- --- 
| v |                               |
         --- --- --- --- --- ---    
|   |   |               |       |   |
             --- ---                
|   |   |         x |       |   |   |
         --- --- --- --- ---        
|   |                           |   |
     --- --- --- --- --- --- ---    
|                                   |
 --- --- --- --- --- --- --- --- --- 