 --- --- --- --- --- --- --- --- --- 
|           |               |     v |
     ---                             
|       |   |       |       |   |   |
 ---             --- ---         --- 
|       |       |     x     |       |
     --- --- --- --- --- --- ---     
|   |       |       |       |       |
                                     
|       |       |       |           |
 --- --- --- --- --- --- --- --- --- 