 --- --- --- --- --- --- --- --- --- 
|                       |           |
     --- --- ---         --- ---     
|   |                   |           |
                 --- ---             
|   |       | x                 |   |
         --- ---     ---             
|   |           |               |   |
     --- ---     --- --- ---         
| ^                                 |
 --- --- --- --- --- --- --- --- --- 